####################
#........#...#.....#
#.00..#00#.#.#.....#
#..#.0.0.#00.#..X..#
##.#..#..#.#.#.....#
#...##.......#.....#
#...#.0.#...##.....# 
#.0.#0.#...###.....# 
##0.#..###########.# 
#..0....^^^^^^^^^^.# 
#...#.@############# 
########
